##############
#P.C..B...CCC#
#..##..#.CCCC#
#..G..C...CCC#
#..B.C.T..CCC#
#CCCCCCCCCCCC#
##############
