###########
#P..B..T..#
#..##..##C#
#..G......#
#G..B..T..#
###########
