##############
#P.C..B...CCC#
#..##..#.CCCC#
#..G..C...COC#
#..B.C.T..CCC#
#CCCCCCCCCCCC#
##############
