###########
#P..B..T..#
#..##..##C#
#..G......#
#...B..T..#
###########
